230,201,201,201,201,201,201,201,201,201,201,201,201,201,201,201,201,201,201,201,201,201,201,201,201,201,201,201,201,260
292,80,80,80,80,80,80,80,80,80,80,80,80,80,80,80,80,80,80,80,80,80,80,80,80,80,80,80,80,293
292,80,80,80,80,80,80,80,80,80,80,80,80,80,80,80,80,80,80,80,80,80,80,80,80,80,80,80,80,293
292,80,80,80,80,80,80,80,80,80,80,80,80,80,80,80,80,80,80,80,80,80,80,80,80,80,80,80,80,293
292,80,80,756,756,756,756,756,756,756,697,580,580,580,80,80,80,80,80,80,80,80,80,80,80,80,80,80,80,293
292,80,80,541,541,541,541,541,541,541,725,580,580,580,80,80,80,80,80,80,80,80,80,80,80,80,80,80,80,293
292,80,80,541,541,541,541,541,541,541,725,580,580,580,80,80,80,80,80,80,80,80,80,80,80,80,80,80,80,293
292,80,80,541,541,541,543,634,541,541,725,580,580,580,80,80,80,80,80,80,80,80,80,80,80,80,80,80,80,293
292,80,80,541,541,541,573,574,541,541,725,580,580,580,80,80,80,80,80,80,80,80,80,80,80,80,80,80,80,293
292,80,80,541,773,774,602,602,541,541,725,580,580,580,80,80,80,80,80,80,80,80,80,80,80,80,80,80,80,293
292,80,80,541,803,804,541,541,541,541,755,756,756,756,80,80,80,80,80,80,80,80,80,80,80,80,80,80,80,293
292,80,80,541,541,541,541,541,541,885,886,886,886,886,856,80,80,80,80,80,80,80,80,80,80,80,80,80,80,293
292,80,80,80,80,80,80,80,80,799,80,80,80,80,80,80,80,80,80,80,80,80,80,80,80,80,80,80,80,293
292,80,80,80,80,80,80,80,80,798,80,80,80,80,80,80,80,80,80,80,80,80,80,80,80,80,80,80,80,293
292,80,80,80,80,80,80,80,80,799,80,80,80,80,80,80,80,80,80,80,80,80,80,80,80,80,80,80,80,293
292,80,80,80,80,80,80,80,80,798,80,80,80,80,80,80,80,80,80,80,80,80,80,80,80,80,80,80,80,293
292,80,80,80,80,80,80,80,828,889,80,80,80,80,80,80,80,80,80,80,80,80,80,80,80,80,80,80,80,293
292,80,80,80,80,80,80,80,798,80,80,80,80,80,80,80,80,80,80,80,80,80,80,80,80,80,80,80,80,293
292,80,80,80,80,80,80,80,80,80,80,80,80,80,80,80,80,80,80,80,80,80,80,80,80,80,80,80,80,293
294,323,323,323,323,323,323,323,323,323,323,323,323,323,323,323,323,323,323,323,323,323,323,323,323,323,323,323,323,264
